32,22,3,

91,91,91,91,91,91,91,91,91,91,91,91,91,91,91,91,91,91,91,91,91,91,91,91,91,91,91,91,91,91,91,91,
91,91,91,91,91,91,91,91,91,91,91,91,91,91,91,91,91,91,91,91,91,91,91,91,91,91,91,91,91,91,91,91,
91,91,91,91,91,91,91,91,91,91,91,91,91,91,91,91,91,91,91,91,91,91,91,91,91,91,91,91,91,91,91,91,
91,91,91,91,91,91,91,91,91,91,91,91,91,91,91,91,91,91,91,91,91,91,91,91,91,91,91,91,91,91,91,91,
91,91,91,91,91,91,91,91,91,91,91,91,91,91,91,91,91,91,91,91,91,91,91,91,91,91,91,91,91,91,91,91,
91,91,91,91,91,91,91,91,91,91,91,91,91,91,91,91,91,91,91,91,91,91,91,91,91,91,91,91,91,91,91,91,
91,91,91,91,91,91,91,91,91,91,91,91,91,91,91,91,91,91,91,91,91,91,91,91,91,91,91,91,91,91,91,91,
91,91,91,91,91,91,91,91,91,91,91,91,91,91,91,91,91,91,91,91,91,91,91,91,91,91,91,91,91,91,91,91,
91,91,91,91,91,91,91,91,91,91,91,91,91,91,91,91,91,91,91,91,91,91,91,91,91,91,91,91,91,91,91,91,
91,91,91,91,91,91,91,91,91,91,91,91,91,91,91,91,91,91,91,91,91,91,91,91,91,91,91,91,91,91,91,91,
91,91,91,91,91,91,91,91,91,91,91,91,91,91,91,91,91,91,91,91,91,91,91,91,91,91,91,91,91,91,91,91,
91,91,91,91,91,91,91,91,91,91,91,91,91,91,91,91,91,91,91,91,91,91,91,91,91,91,91,91,91,91,91,91,
91,91,91,91,91,91,91,91,91,91,91,91,91,91,91,91,91,91,91,91,91,91,91,91,91,91,91,91,91,91,91,91,
91,91,91,91,91,91,91,91,91,91,91,91,91,91,91,91,91,91,91,91,91,91,91,91,91,91,91,91,91,91,91,91,
91,91,91,91,91,91,91,91,91,91,91,91,91,91,91,91,91,91,91,91,91,91,91,91,91,91,91,91,91,91,91,91,
91,91,91,91,91,91,91,91,91,91,91,91,91,91,91,91,91,91,91,91,91,91,91,91,91,91,91,91,91,91,91,91,
91,91,91,91,91,91,91,91,91,91,91,91,91,91,91,91,91,91,91,91,91,91,91,91,91,91,91,91,91,91,91,91,
91,91,91,91,91,91,91,91,91,91,91,91,91,91,91,91,91,91,91,91,91,91,91,91,91,91,91,91,91,91,91,91,
91,91,91,91,91,91,91,91,91,91,91,91,91,91,91,91,91,91,91,91,91,91,91,91,91,91,91,91,91,91,91,91,
91,91,91,91,91,91,91,91,91,91,91,91,91,91,91,91,91,91,91,91,91,91,91,91,91,91,91,91,91,91,91,91,
91,91,91,91,91,91,91,91,91,91,91,91,91,91,91,91,91,91,91,91,91,91,91,91,91,91,91,91,91,91,91,91,
91,91,91,91,91,91,91,91,91,91,91,91,91,91,91,91,91,91,91,91,91,91,91,91,91,91,91,91,91,91,91,91

131,132,131,132,131,132,131,132,131,132,131,132,131,132,131,132,131,132,131,132,131,132,131,132,131,132,131,132,131,132,131,132,
147,148,147,148,147,148,147,148,147,148,147,148,147,148,147,148,147,148,147,148,147,131,132,148,147,148,147,148,147,148,147,148,
131,147,148,162,161,162,161,162,161,162,161,162,161,162,161,162,161,162,161,162,161,147,148,162,161,162,161,162,161,132,131,132,
147,148,162,0,0,0,0,0,0,0,0,0,0,0,0,0,0,0,0,0,145,131,132,146,0,0,0,0,0,161,147,148,
131,132,146,0,0,0,0,0,0,0,0,0,0,0,0,0,0,0,0,0,161,147,148,162,0,0,81,0,0,145,131,132,
147,148,162,0,0,202,135,136,135,136,135,136,135,136,135,136,135,136,135,136,151,161,162,0,0,0,177,178,0,161,147,148,
131,132,146,0,0,218,0,0,0,0,0,0,0,0,0,0,149,0,0,0,0,0,0,0,0,0,193,194,0,145,131,132,
147,148,162,0,0,202,0,0,0,0,149,149,168,149,0,0,149,0,0,0,0,0,0,0,0,0,0,0,0,161,147,148,
131,132,146,0,0,218,0,0,0,151,149,0,0,149,0,0,168,0,0,101,101,101,101,101,101,101,0,0,0,145,131,132,
162,161,162,0,0,113,114,0,0,149,0,0,151,151,0,0,149,0,0,0,0,0,0,0,0,101,101,0,0,161,162,161,
0,0,0,0,0,129,130,0,0,149,0,151,0,0,0,0,149,210,0,210,0,210,0,210,0,0,101,0,0,0,0,0,
0,0,0,0,0,202,0,0,0,149,0,0,0,151,151,151,0,226,101,226,101,226,101,226,0,0,101,0,0,0,0,0,
146,145,146,0,0,218,0,0,0,168,149,0,0,0,0,0,0,0,0,0,0,0,0,0,0,0,101,13,14,145,146,145,
147,148,162,0,0,202,0,0,0,0,149,242,243,242,243,242,243,242,243,242,243,242,243,242,243,101,101,29,30,161,147,148,
131,132,146,0,0,218,0,0,0,0,0,0,0,0,0,0,0,0,0,0,0,0,0,0,0,211,0,145,146,145,131,132,
147,148,162,0,0,202,99,0,99,0,99,0,99,0,99,0,99,0,99,0,99,0,0,0,0,227,145,131,132,131,132,148,
131,132,146,0,0,218,115,99,115,99,115,99,115,99,115,99,115,99,115,99,115,99,0,0,0,0,161,147,148,147,148,132,
147,148,162,0,0,0,0,115,0,115,0,115,151,115,0,115,0,115,151,115,0,115,0,0,0,0,145,131,132,131,132,148,
131,132,146,0,0,0,0,0,0,0,0,0,0,0,0,0,0,0,0,0,0,0,0,0,0,0,161,147,148,147,148,132,
147,148,147,146,145,146,145,146,145,146,145,146,145,146,145,146,145,146,145,146,145,146,145,146,145,146,145,131,132,148,147,148,
131,132,131,132,131,132,131,132,131,132,131,132,131,132,131,132,131,132,131,132,131,132,131,132,131,132,131,147,148,132,131,132,
147,148,147,148,147,148,147,148,147,148,147,148,147,148,147,148,147,148,147,148,147,148,147,148,147,148,147,148,147,148,147,148

0,0,0,0,0,0,0,0,0,0,0,0,0,0,0,0,0,0,0,0,0,0,0,0,0,0,0,0,0,0,0,0,
0,0,0,0,0,0,0,0,0,0,0,0,0,0,0,0,0,0,0,0,0,0,0,0,0,0,0,0,0,0,0,0,
0,0,1,1,1,1,1,1,1,1,1,1,1,1,1,1,1,1,1,1,1,1,1,1,1,1,1,1,1,1,0,0,
0,0,1,0,0,0,0,0,0,0,0,0,0,0,0,0,0,0,0,0,1,0,0,1,0,0,0,0,0,1,0,0,
0,0,1,0,0,0,0,0,0,0,0,0,0,0,0,0,0,0,0,0,1,0,1,1,0,0,1,0,0,1,0,0,
0,0,1,0,0,1,1,1,1,1,1,1,1,1,1,1,1,1,1,1,1,1,1,0,0,0,1,1,0,1,0,0,
0,0,1,0,0,1,0,0,0,0,0,0,0,0,0,0,1,0,0,0,0,0,0,0,0,0,1,1,0,1,0,0,
0,0,1,0,0,1,0,0,0,0,1,1,1,1,0,0,1,0,0,0,0,0,0,0,0,0,0,0,0,1,0,0,
0,0,1,0,0,1,0,0,0,1,1,0,0,1,0,0,1,0,0,1,1,1,1,1,1,1,0,0,0,1,0,0,
1,1,1,0,0,1,1,0,0,1,0,0,1,1,0,0,1,0,0,0,0,0,0,0,0,1,1,0,0,1,1,1,
0,0,0,0,0,1,1,0,0,1,0,1,0,0,0,0,1,0,0,0,0,0,0,0,0,0,1,0,0,0,0,0,
0,0,0,0,0,1,0,0,0,1,0,0,0,1,1,1,0,1,1,1,1,1,1,1,0,0,1,0,0,0,0,0,
1,1,1,0,0,1,0,0,0,1,1,0,0,0,0,0,0,0,0,0,0,0,0,0,0,0,1,1,1,1,1,1,
0,0,1,0,0,1,0,0,0,0,1,1,1,1,1,1,1,1,1,1,1,1,1,1,1,1,1,1,1,1,0,0,
0,0,1,0,0,1,0,0,0,0,0,0,0,0,0,0,0,0,0,0,0,0,0,0,0,1,1,1,1,1,0,0,
0,0,1,0,0,1,1,0,1,0,1,0,1,0,1,0,1,0,1,0,1,0,0,0,0,1,1,0,0,1,0,0,
0,0,1,0,0,1,1,1,1,1,1,1,1,1,1,1,1,1,1,1,1,1,0,0,0,0,1,0,0,1,0,0,
0,0,1,0,0,0,0,1,0,1,0,1,1,1,0,1,0,1,1,1,0,1,0,0,0,0,1,0,0,1,0,0,
0,0,1,0,0,0,0,0,0,0,0,0,0,0,0,0,0,0,0,0,0,0,0,0,0,0,1,0,0,1,0,0,
0,0,1,1,1,1,1,1,1,1,1,1,1,1,1,1,1,1,1,1,1,1,1,1,1,1,1,1,1,1,0,0,
0,0,0,0,0,0,0,0,0,0,0,0,0,0,0,0,0,0,0,0,0,0,0,0,0,0,0,0,0,0,0,0,
0,0,0,0,0,0,0,0,0,0,0,0,0,0,0,0,0,0,0,0,0,0,0,0,0,0,0,0,0,0,0,0
